10 12
WWWWWWWWWWWW
BBBBBBWBBBBW
WBWWWBWBWWBW
WBBBBBBBWWBW
WBWWWWWBWWBW
WBBBWWBBBBBB
WWWBWWWWWWBW
WWWBBWBBBBBW
WWWWBBBWWWWW
WWWWWWWWWWWW
